49 27
x...............................................x
x...............................................x
x...............................................x
x...............................................x
x............x..................................x
x...........xx...x..............................x
x.p.x......xxx..xxx.............................x
xxxxxx..xxxxxxxxxxxxxxxxxx...x..................x
x........................x...x..................x
x........................x...x..................x
x........................x...xxxxxxxxxxxxxxx....x
x...............................................x
x...............................................x
x..............xxxxxxxxx.......xxxxxxxxxxxxxxxxxx
x...............................................x
x...............................................x
x...............................................x
x...............................................x
x...............................................x
x...............................................x
x...............................................x
x...............................................x
x...............................................x
x...............................................x
x...............................................x
x...............................................x
x...............................................x
