49 27
xxxxxxxxxxxxxxxxxxxxxxxxxxxxxxxxxxxxxxxxxxxxxxxxx
x...............................................x
x...............................................x
x...............................................x
x...x...........................................x
x............x..................................x
x...........xx...x..............................x
x.p.......axxxssxxx.............................x
xxxxx.x.xxxxxxxxxxxxxxxxxx...x..................x
x........................x...x..................x
x........................x...x..................x
x........................x...xxxxxxxxxxxxxxx....x
x...............................................x
x.................a.............................x
x..............xxxxxxxxx.......xxxxxxxxxxxxxxxxxx
x...............................................x
x...............................................x
x...............................................x
x...............................................x
x...............................................x
x...............................................x
x...............................................x
x...............................................x
x...............................................x
x...............................................x
x...............................................x
xsssssssssssssssssssssssssssssssssssssssssssssssx
